e9943132-5ebf-41a1-895b-a278cfc1adef,,,,,,,,
W,W,W,W,W,W,W,W,W
W,,,,,,P1R4,,W
W,,,,,,,,W
W,,,,,,,,W
W,,,,F,,,,W
W,,,,,,,,W
W,,,,,,,,W
W,,P2L4,,,,,,W
W,W,W,W,W,W,W,W,W