cdeeadf2-31c9-48f4-852f-778b58086dd0,,,,,,,,,,,,,,
W,W,W,W,W,W,W,W,W,W,W,W,W,W,W
W,C2,C2,C2,W,C1,C1,C1,C1,C1,C1,C1,C1,C1,W
W,C2,W,C2,W,C1,C1,C1,C1,C1,C1,C1,C1,C1,W
W,C2,C2 P2L8,C2,C1,C1,C1,C1,C1,C1,C1,C1,C1,C1,W
W,C2,W,W,W,W,W,W,W,W,W,C1,W,C1,W
W,C4,W,C3,C3,C3,C3,C3,C3,C3,C3,C3,W,C1,W
W,C4,W,C4,W,W,W,W,W,W,W,W,W,C5,W
W,C4,C4,C4,C4,C4,C4,C4,C4,C4,C4,C5,C5 P1R8,C5,W
W,C4,C4,C4,C4,C4,C4,C4,C4,C4,W,C5,W,C5 F,W
W,C4,C4,C4,C4,C4,C4,C4,C4,C4,W,C5,C5,C5,W
W,W,W,W,W,W,W,W,W,W,W,W,W,W,W