88688ca9-d723-41ba-adb4-854196dfca2f,,,,,,
W,W,W,W,W,W,W
W,C1,C1,C1,C1 P1R3,C1,W
W,C1,C1,C1,C1,C1,W
W,W,W,C1,C1,C1,W
W,C2,C2,W,C1,C1,W
W,C2,C2,C2,W,C1,W
W,C2,C2,C2 F,C2,C2,W
W,C3,W,C2,C2,C2,W
W,C3,C3,W,C2,C2,W
W,C3,C3,C3,W,W,W
W,C3,C3,C3,C3,C3,W
W,C3,C3 P2L3,C3,C3,C3,W
W,W,W,W,W,W,W