HEADER ROW IS IGNORED,,,,,,,,,,,,,,,,,,
W,W,W,W,W,W,W,W,W,W,W,W,W,W,W,W,W,W,W
W,,,,,,,,,,,,,,,,,,W
W,,,,,,,,,,,,,,,,,,W
W,,,,,,,,,,,,,,,,,,W
W,,,,,,,,,,,,,,,,,,W
W,,,,,,,,,,,,,,,,,,W
W,,,,,,,,,,,,,,,,,,W
W,,,,,,,,,,,,,,,,,,W
W,,,,,,,,,,,,,,,,,,W
W,,,,,P1R2,,,,F,,,,P2L2,,,,,W
W,,,,,,,,,,,,,,,,,,W
W,,,,,,,,,,,,,,,,,,W
W,,,,,,,,,,,,,,,,,,W
W,,,,,,,,,,,,,,,,,,W
W,,,,,,,,,,,,,,,,,,W
W,,,,,,,,,,,,,,,,,,W
W,,,,,,,,,,,,,,,,,,W
W,,,,,,,,,,,,,,,,,,W
W,W,W,W,W,W,W,W,W,W,W,W,W,W,W,W,W,W,W